111111111111111111111111111111111111111111
1C0110001C00000000000010111C001C10000C0111
1100001001101000P1100000C10000001101010011
1001000100000C0100001010000000001010100E11
1100100000010100010000000000100000C0000001
101C11000C0000C00100000010000010010C010101
111111111111111111111111111111111111111111