11111111111111111111111111111111111111111111111111
10100000000000E00000000X000C000000110000X000000011
1000100010010010100000011110000010000000X000111001
10110000100011000000C1C000X0000000X0011111X11000X1
101000X000000C01000000X10000X0000C0000000C00110001
1000C00000010101000X0000C0000000C00000C00000000C01
10110000100011000000C1C000X0000000X0011111X11000X1
1000011100100100000C000X0000X0000XC00000C0C0C00001
100000010C1000101000011111111110010011110100011101
110000X01001100000011000000000011000000001111C0001
10100000000000001C0000000000C00000000C000000000001
11100000X00110001001111111000000000100010011000001
10110000100011000000C1C000X0000000X0011111X11000X1
1010C000C00X0000C00000000C000000000000X000X0000X01
11100110001000000C0000C0000X0001111110000100100001
10000X000011010100000000X000C00000C00000C0X0001111
10110000100011000000C1C000X0000000X0011111X11000X1
110E00001C0000001C1111100000C00C000000000X00000X01
100001X00C101000100000000CC000000X00111101110X0001
100010010011000101111X00000000X000000C00000C00X001
101000101C0001000X000000X000C0000C00000C0000011111
101100X010X0110X0000C1C000X0000000X0011111X11000X1
11010100001001C00000000000C0000C0000000000C0010001
101011000CP0C0X00X00000000C0000C00X0000000X0000C01
100C00011100000110X0000000C0000000C000000000E0X011
101100X0100011000000C1C000X0000000X0011111X11000X1
11111111111111111111111111111111111111111111111111