1111111111111111111111111111111111111111
10100000000000E00000000X000C00X000000011
100010001001001010000001111000X000111001
10110000100011000000C1C000X00011X11000X1
101000X000000C01000000X10000X00C00110001
1000C00000010101000X0000C000000000000C01
10110000100011000000C1C000X00010X11000X1
1000011100100100000C000X0000X0C0C0C00001
100000010C100010100001111111100100011101
110000X0100110000001100000000101111C0001
10100000000000001C0000000000C00000000001
11100000X0011000100111111100000011000001
10110000100011000000C1C000X00011X00000X1
1010C000C00X0000C00000000C000000X0000X01
11100110001000000C0000C0000X010100100001
101000101C0001000X000000X000C00000011111
101100X010X0110X0000C1C000X00011X00000X1
11010100001001C00000000000C00C00C0010001
101011000CP0C0X00X00000000C00C00X0000C01
100C00011100000110X0000000C0000000E0X011
101100X0100011000000C1C000X00011X01000X1
1111111111111111111111111111111111111111