1111111111111111111111111111
1000100000C000000XC0000000C1
1000111000100000000010001111
10000X00001000011000111111E1
10P0000000000000000000000001
100000000000000C100000000001
100010000000X001000000000001
100011100100C0000C0010001111
1000000100000000000011111111
100C000100000X00C00000000001
10000010000000X000000000C001
1111111111111111111111111111