1111111111111
10010000000C1
10X0011X00001
1P0011E00X001
1111111111111